  NO ./textures/mossy.xpm
R      680    480   

SO     ./textures/eagle.xpm
    
   
EA    ./textures/wood.xpm
       WE ./textures/greystone.xpm
  
S    ./textures/barrel.xpm
F       ./textures/bluestone.xpm
C   ./textures/redbrick.xpm
 
   


        1111111111111111111111111
        1000000000110000000000001
        1011000001110000002000001
        1001000000000000000000001
111111111011000001110000000000001
100000000011000001110111111111111
11110111111111011100000010001
11110111111111011101010010001
11000000110101011100000010001
10002000000000001100000010001
100000000000000011010100100011
11000001110101011111011110N0101
11110111 1110101 1011110100011011  
11111111 1111111 111111111111 1