  NO ./textures/eagle.xpm
R      560   880   

SO     ./textures/bluestone.xpm
F       ./textures/wood.xpm

EA    ./textures/greystone.xpm
       WE ./textures/redbrick.xpm
  
  

C   ./textures/mossy.xpm
 
S    ./textures/barrel.xpm
   
     

        11111111111111
    11111100000011000011111
  11100200000000020000000011
110000000S0000000000000000001
11222222222222000000002222221
1000001     10000000000110001 
1000001     10000000000000011
1100001      1000000000000211
1100001      1000000000000001
11111111111111111111111111111111  

     
       
